###############
#.............#
#.#.#.#.#.#.#.#
#......¤...µ..#
#.#.#.#µ#.#.#.#
#.............#
#.#µ#.#.#.#.#.#
#..........µ..#
#.#.#.#.#.#.#.#
#.............#
#.#.#.#.#.#.#.#
#..µ..........#
#..........µ..#
#.............#
#SSSSSSSSSSSSS#
###############
